111111111111111
1100C00000001E1
1000000P0000001
100000C00000001
111111111111111