1111111111111111111
100100000001100C001
100C011111000011C11
1000110000000100101
1111111101111C00001
10C1000C00011C0C0C1
1000011111001C00C01
10P0101000001C00001
1010000010100001001
1111111010101010111
1111111CCCCCCCC0EC1
1111111111111111111