11111111111111111111111
1E0000000000000C00000C1
10100101001000001010011
1W100100101010100010011
1P0000W00C00C0000000001
10000000W0000CCCC0000C1
10000000W0000CCCC0000C1
10000000W0000CCCC0000C1
10000000W0000CCCC0000C1
11111111111111111111111